all			la
and			tegashe
animal			lo
ashes			bewa
at			da
back			laxole
bad			raluna
bark			so
because			rwa
belly			no
big			ka
bird			shiyu
bite			nwa
black			zato
blood			zho
blood			o
blow			enapano
bone			ra
breast			ba
breathe			ko
brother			amo
burn			naRa
child			pu
clothing			Rezhora
cloud			zo
claw			wa
cold			Ro
come			nada
cook			leshi
count			gu
cut			go
dance			xa
day			zhwaxwa
die			ro
dig			xushwa
dirty			zhe
dog			yeRo
drink			zhwa
dry			ya
dull			Ra
dust			po
ear			mwadi
earth			za
eat			eswegwa
egg			re
eight			shaze
eye			aro
fall			pe
far			aza
fat/grease			lwa
father			teno
fear			de
feather			zhara
few			ma
fight			she
fire			telo
fish			na
five			shi
float			ga
flow			rusharo
flower			zame
fog			shabwaxa
foot			zenwa
four			agarwa
freeze			nadwa
fruit			sa
full			gwa
give			zwa
good			me
grass			Re
green			rwawanu
guts			a
hair			yu
hand			ze
head			zhu
hear			leRo
heart			se
heavy			yeRe
here			noRa
hit			ne
hold/take			raxe
horn			zha
how			mo
hundred			sha
hunt			zhapomo
husband			sworo
ice			yo
if			reRu
in			te
kill			xo
knee			rotwa
know			dopa
lake			gi
laugh			tume
leaf			ose
left side			ago
leg			shwarwa
lie			gakwalo
live			bo
liver			yadaro
long			i
louse			lata
man/male			shuke
many			maRa
meat/flesh			ge
moon			ta
mother			shobe
mountain			kaRa
mouth			goroRa
name			xare
narrow			zhada
near			shu
neck			zhesha
new			loyo
night			laRa
nose			be
not			bu
old			ana
one			xwa
other			pwa
person			xwala
play			shanewa
pull			ye
push			do
rain			lota
red			sho
right (correct)			swa
right (side)			zu
river			waleli
road			shaRo
root			zhapanane
rope			ru
rotten			mi
rub			nuzhaxa
salt			u
sand			zapesa
say			le
scratch			zelu
sea			mwama
see			name
seed			zhexa
seven			mazu
sew			nimepumanoRo
sharp			yoRi
shoot			yilu
short			lereye
sing			gonwaserwa
sister			Ru
sit			zhepama
skin			su
sky			nu
sleep			mu
small			bwa
smell			xwade
smoke			dwa
smooth			nedalewa
snake			malwa
snow			loyaya
some			leRa
spear			zhoRe
spit			pa
split			zi
squeeze			kagwa
stab/pierce			ni
stand			e
star			RaRe
stick			raxu
stone			xe
straight			azha
suck			moyeta
sun			losa
swell			mwa
swim			Riro
tail			luwa
ten			ramwa
that			razhwa
there			wanemaya
they			laza
thick			banoshawayura
thin			Ri
think			aga
this			oku
three			zhwashazhu
throw			kepiRo
tie			kwa
tongue			to
tooth			zuzwa
tree			mwapane
turn			shwa
twenty			rora
two			elotwa
vomit			zwanate
walk			ware
warm			Rela
wash			neRa
water			otama
wet			zalu
what?			bapi
when?			lemanewa
where?			batota
white			tu
who?			suka
wide			zara
wife			xu
wind			ludoba
wing			roga
wipe			moxa
with			ke
woman			yora
woods			twalu
work			laye
worm			lixuso
year			gesa
